###############################################
#     ....    #                 #        #    #
#             #                #####     #    #
#     ####    #                          #    #
#        #    #           #              #    #
#        #    #           #  ...     #####    #
#            ####         # ....              #
#                         #                   #
#    .......              ################    #
#                    #####                    #
#                                 #####       #
#    ###  ###                     #   #       #
#           #    ...........     ##   ####    #
#           #                                 #
###############################################
